NO textures/alex.png
SO textures/NB.png
WE textures/arctic_Monkeys.png
EA textures/cursed.png


F 0,255,0
C 0,0,255

11111111111111111111111111111111111111111111111111111111111
10000000000000000000000000000000000000000000000000000000001
10000000000000000000000000000000000000000000000000000000001
10000000000000000000000000000000000000000000000000000000001
10000000000010000000000001000000000000000000000000000000001
10000000010000000000000000010000000000000000000000000000001
10000000000000000E00000000000000000000000000000000000000001
10000000000000000000000000000000000000000000000000000000001
10000000000010000000010000000000000000000000000000000000001
10000000000000000000000000000000000000000000000000000000001
10000000000000000000000000000000000000000000000000000000001
10000000000000000000000000000000000000000000000000000000001
10000000000000000000000000000000000000000000000000000000001
11111111111111111111111111111111111111111111111111111111111