NO textures/alex.png
SO textures/NB.png
WE textures/arctic_Monkeys.png
EA textures/cursed.png


F 0,255,0
C 0,0,255

1111111111111111111111111111111111111111111111111111111111111
1111111111111111111111111111111111111111111111111111111111111
1100000000000000000000000000000000000000000000000000000000011
1100000000000000000000000000000000000000000000000000000000011
1100000000000000000000000000000000000000000000000000000000011
1100000000000100000000000010000000000000000000000000000000011
1100000000100000000000000000100000000000000000000000000000011
110000000000000000E000000000000000000000000000000000000000011
1100000000000000000000000000000000000000000000000000000000011
1100000000000100000000100000000000000000000000000000000000011
1100000000000000000000000000000000000000000000000000000000011
1100000000000000000000000000000000000000000000000000000000011
1100000000000000000000000000000000000000000000000000000000011
1100000000000000000000000000000000000000000000000000000000011
1111111111111111111111111111111111111111111111111111111111111
1111111111111111111111111111111111111111111111111111111111111