NO textures/alex.png
SO textures/NB.png
WE textures/arctic_Monkeys.png
EA textures/cursed.png


F 255,0,0
C 0,0,0

11111111111111111111111111111111111111111111
10000000000000000000000000000000000000000001
10000000000000000000000000000000000000000001
10000000000000000000000000000000000000000001
10000000000000000000000000000000000000000001
10000000000000000000000000000000000000000001
10000000000000000000000000000110000000000001
10000000000000000000000000000110000000000001
10000000000000000000000000000000N00000000001
10000000000000000000000000000000000000000001
10000000000000000000000000000000000000000001
11111111111111111111111111111111111111111111