NO textures/north.png
SO textures/south.png
WE textures/west.png
EA textures/east.png


F 255,0,0
C 0,0,0

11111111111111111111111111111111111111111111
10000000000000000000000000000000000000000001
10000000000000000000000000000000000000000001
10000000000000000000000000000000000000000001
10000000000000000001000000000000000000000001
10000000000000000000100000000000000000000001
10000000000000000000000000000110000000000001
10000000000000000000000000000110000000000001
10000000N00000000000000000000000000000000001
10000000000000000000000000000000000000000001
10000000000000000000000000000000000000000001
11111111111111111111111111111111111111111111