NO textures/alex.png
SO textures/metro_boomin.png
WE textures/IAM_IWAS.png
EA textures/3.jpg


F 0,255,0
C 0,0,255

        1111111111111111111111
        1000000000110000000001
        1011000001110000000001111   111
        1001000000000000000000001   101
111111111011000001110000000000001   101
1N00000000110000011101111111111 1   111
111101111111110111000000100011
111101111111110111010100100011
100000000000000011000000100011
100000000000000011000000100011
100000000000000011010100100011
111111111010101111101111001111
11110111 1110101 1011110100011
11111111 1111111 1111111111111
