NO textures/arctic_Monkeys.png
SO textures/metro_boomin.png
WE textures/IAM_IWAS.png
EA textures/3.jpg


F 85,40,33
C 255,0,0

        1111111111111111111111111
        1000000000110000000000001
        1011000001110000000000001
        1001000000000000000000001
111111111011000001110000000000001
100000000011000001110111111111111
11110111111111011100000010001
11110111111111011101010010001
10000000000000001100000010001
1000000N000000001100000010001
10000000000000001101010010001
11111111101010111110111100111
11110111 1110101 101111010001
11111111 1111111 111111111111
