SO textures/NB.png

NO textures/alexx.png

WE textures/arctic_Monkeys.png

EA textures/cursed.png

F 0,0,0
C 0,0,0

1111111111111111111111111111
1000000100000000000000000001
1E00000100000000000000000001
1000000000000000000000000001
1000000000000010000010000001
1000000000000000000000000001
1000000000000000000000000001
1000000000000000000000000001
1000000000000000000000000001
1000000000000000000000000001
1000000000000000000000000001
1000000000000000000000000001
1000000000000000000000000001
1111111111111111111111111111