NO textures/alexx.png
SO textures/NB.png
WE textures/arctic_Monkeys.png
EA textures/cursed.png


F 0,255,0
C 0,0,255

1111111111111111111111111111
1000000100000000000000000001
1000000000000000000100000001
1000000100000E00000000000001
1000000000000000000000000001
1000000000000010000010000001
1000000000000000000000000001
1000000000000000000000000001
1000000000000000000000000001
1000000000000000000000000001
1000000000000000000000000001
1000000000000000000000000001
1000000000000000000000000001
1000000000000000000000000001
1111111111111111111111111111
