NO textures/alexx.png
SO textures/NB.png
WE textures/arctic_Monkeys.png
EA textures/cursed.png


F 85,40,33
C 255,0,0

1111111111111111111
1000000000100000001
1011111010101111101
1010000010000000101
1010111101111100101
10100000N0000100101
1010111111100100101
1010000000000100101
1011111010111100101
1000001010100000001
1111011010111111101
1000010000000000101
1011111010111101101
1000000010000000001
1111111111111111111
