NO textures/alexx.png
SO textures/NB.png
WE textures/arctic_Monkeys.png
EA textures/cursed.png


F 0,0,0
C 0,0,0

111111111111111
100000000000001
100100000010001
1S0001000000001
101000000000001
101000001000001
101000000010001
101001000000001
101000000100001
101100000000001
111111111111111
