NO textures/alex.png
SO textures/NB.png
WE textures/arctic_Monkeys.png
EA textures/cursed.png


F 0,0,0
C 0,0,0

111111111111111
100000000000001
100100000010001
100001000000001
101000000000001
101000001000001
101000000010001
10100N000000001
101000000100001
101100000000001
111111111111111