NO ./textures/north.png
SO ./textures/south.png
WE ./textures/west.png
EA ./textures/east.png

F 9,183,163
C 180,42,193

111111111
11111101110011
1010010011
1000001110101
1111111101
11110101101
11011101100001
1110101111E0101
111111111111111
