NO ./textures/north.png
SO ./textures/south.png
WE ./textures/west.png
EA ./textures/east.png

F 141,107,86
C 254,170,48

111111
110S1
10100111
10111
10010001
10001011
111001
1011110111
100111011
1001011
10110111
10011
111111
