NO ./textures/north.png
SO ./textures/south.png
WE ./textures/west.png
EA ./textures/east.png

F 112,213,230
C 75,52,135

1111
10101
1101
101
1101101
1110101
1001
111
10S011
1011
111
1010011
10111
11011
1001101
1111111
