NO ./textures/north.png
SO ./textures/south.png
WE ./textures/west.png
EA ./textures/east.png

F 81,189,47
C 25,103,76

1111111
11000111111
1101100S1111
1100100101111
1011001111001
1000110111001
1100001111111
101110111001
110111101101
1010101011001
1111111111111
