NO ./textures/north.png
SO ./textures/south.png
WE ./textures/west.png
EA ./textures/east.png

F 44,86,97
C 125,219,0

11111
11E1
1001
111
100111
1001
1101
100011
10001
1101
1101
1111
