NO ./textures/north.png
SO ./textures/south.png
WE ./textures/west.png
EA ./textures/east.png

F 6,255,140
C 254,204,216

111111111111111
111S111100101
1011100011
100011000101
1010111
1011000111
10111011010001
111111111111111
