NO ./textures/north.png
SO ./textures/south.png
WE ./textures/west.png
EA ./textures/east.png

F 79,191,88
C 223,94,251

111111111
11100011
10001000011
111100101111
10011001011011
1111100001
11100110011
101111101101
11011N1111
1011111011101111
111011110111
110110011
111101001
101000101001
111111111111111
