NO ./textures/north.png
SO ./textures/south.png
WE ./textures/west.png
EA ./textures/east.png

F 204,208,96
C 87,109,255

11111111111
10000110001
10000011111
1111100100010000011
10000101010110101
100010101011
1001100111000101
111101000001
111101000W11
100110010110111
1111111111111111
