NO ./textures/north.png
SO ./textures/south.png
WE ./textures/west.png
EA ./textures/east.png

F 81,189,47
C 25,103,76



1

111111111111111
100000000000001
100100000010001
100001000000001
101000000000001
1010000010000N1
101000000010001
101001000000001
101000000100001
101100000000001
111111111111111
